 #   # # #   #     # #       
 # # # # ### ##### # # ### ##
   #   #     #   #     # # # 
## ### ### # # # ####### # # 
   # #   # #   # #           
 ### # ##### # # ####### ####
 # #   #     # # #         # 
## # ### ### ####### ####### 
 #       #             #   # 
 ### ############# ####### # 
     #                 #     
## ### ##### ##### # # # # ##
 #   # #     # # # # #   #   
 ### ### ### # # ##### # # ##
     #     #       #   # #   
 # ##### ### ##### ####### ##
 #   #   #       #       #   
 ##### # ### ### # ### # ### 
     # # #     # #   # # #   
