     #     #       #         
 # # # ### # ### # ### ##### 
 # #   #       # # # #   #   
########## ### ### # ##### ##
       #     # #   # #   #   
 # ##### ### # ### # # # # ##
 #   #     # #   # # # # #   
 ### # # # ####### # ### # # 
   #   # # #   #   #     # # 
 ####### # ### ##### ### # ##
 #       #   #   # #   #     
## ##### ### # # # # # ######
     # # #     #   # # #   # 
#### # # ##### ##### # # # # 
 #     # # #     # # # # #   
 ##### ### # ### # # ##### ##
         #     #     #     # 
## ### # ##### # ### ### ### 
   #   #     # #   #         
