 # #       #         #       
 # # ### # ####### ##### ####
   # #   # #   # # # #       
## ### ####### # # # ### # # 
   # #       #   # #     # # 
 ### # ##### # ### # ### # ##
         # # #   # # #   #   
 # # # ### # # # # # ########
 # # # #   #   #   #         
## ##### ### ### # ### ##### 
 #     # #     # #   #   #   
 # # ### ### ##### # ####### 
   # #   #   # #   #         
 # # # ### ### # ##### ##### 
 # #   #   #   # #       #   
 ### # ##### # ### ##### ### 
   # #   #   #     # #   #   
 ######### ### ##### # ######
   #         #   #           
